اینصورت	این صورت
گزارشات	گزارش‌ها
میتواند	می‌تواند
میباشد	می‌باشد
میکنید	می‌کنید
میکند	می‌کند
میکنند	می‌کنند
میشود	می‌شود
بصورت	به صورت
بمنظور	به منظور
بوجود	به وجود
میدهد	می‌دهد
باتوجه	با توجه
الویت	اولویت
می توانیم	می‌توانیم
دقیق تر	دقیق‌تر
آنها	آن‌ها
اینکه	این که
آنکه	آن که
پیشتر	پیش‌تر
بیشتر	بیش‌تر
کمتر	کم‌تر
اینحال	این‌حال
مهمترین	مهم‌ترین
مهمتر	مهم‌تر
همانطور	همان طور